1111111000
1000001111
0011111000
1110000010
0011111111